NO ./path_texture.xpm
SO ./path_texture.xpm
WE ./path_texture.xpm
EA ./path_texture.xpm

F 164,169,20
C 153,204,255

11111111111111111111
10000000000000000001
10000000000000000001
10001010101010101001
10000000000000000001
10000000000000001001
100000000000N0010001
10000000000000001001
10000000000001111001
10000000000000000001
10000000000000000001
10000000000000000001
11111111111111111111