NO ./path_texture.xpm
SO ./path_texture.xpm
WE ./path_texture.xpm
EA ./path_texture.xpm

F 164,169,20
C 153,204,255


1111111111111111111
1001001001001000001
1011000001000001001
1001001001111101111
1001111000001001001
1000000000000001001
1001111111111001001
11110000N0000001011
1000000001000000001
1111111111111111111