NO ./texture/wood.png
SO ./texture/redbrick.png
WE ./texture/greystone.png
EA ./texture/wood.png

F           153,204,255                                        
C 209,160,240



              1111111111  1111111
              11111111    1111111
              11111111    1111111
              11111111    1111111
              1111111111111111111
              1001001000001001001
              1001001001001001001
              1001001001001001001
              1001001000001001001
              1000000000000000001
              1000011111111000001
              1111100000000001111
              1000S00101010000001
              1111111111111111111







