NO ./path_texture.xpm
SO ./path_texture.xpm
WE ./path_texture.xpm
EA ./path_texture.xpm

F 164,70,200
C 153,204,255

11111
1N111
10001
11111