NO texture/azro_wall.png                                                                                                                                                                          
SO texture/black_wall.png
WE texture/brick_wall.png                                                                                                                 
EA texture/wall_paper1.png
F 184,113,39
C 51,198,227



                        1    1
1111111111111111111111111111101
1000000000110000000000000000101
101100000111000000011110111111
11111111110000000000000000011111
11    10110000011100000000000111111
 1111111  1000000000110000011111111111
11111111111111011100000010001
11110111111111011101010010001
11000000110101011100000010001
10000000000000001100000010001
10000000000000001100010000001
11000000110101000000000000001
11110111110101000000000000001
10000000001100000100000010001
10000000000000000000000001001
10000000111100010000000001001
100000001  100100101110000001
100000001111100N0001 10100001
11111111111111111111 1111111