NO texture/azro_wall.png                                                                                                                                                                          
SO texture/black_wall.png
WE texture/brick_wall.png                                                                                                                 
EA texture/wall_paper1.png

F 153,204,255                                        
C 209,160,240

 11111111111111111111111111111111111111111111111111111111111111
1000000000000000000000000000000000000000000000000000000001110101
1000000000000000000000000000000000000000000000000000000000100001
1000000000000000000000000000000000000000000000000000000001010011
1000000000000000000000000000000000000000000000000000000000011111
1000000000000000000000000000000000000000000000000000000001011111
1000000000000000000000000000000000000000000000000000000001110001
1000000000000000000000000000000000000000000000000000000000101011
1000000000000000000000000000000000000000000000000000000000001011
1000000000000000000000000000000000000000000000000000000000110011
1000000000000000001100000000000000000000000000000000000001110111
1000000000000000001100000000000000000000000000000000000001000101
1000000000000000001100000000000000000000000000000000000001010011
1000000000000000001100000000000000000000000000000000000000000101
1000000000000000001100000000000000000000000000000000000000101101
1000000000000000001100000000000000000000000000000000000001101101
1000000000000000001100000000000000000000000000000000000000011101
1000000000000000001100000000000000000000000000000000000000011111
1000000000000000001100000000000000000000000000000000000001010011
1000000000000000001100000000000000000000000000000000000001110011
1000000000000000001100000000000000000000000000000000000000111001
1000000000000000001100000000000000000000000000000000000001111111
1000000000000000001100000000000000000000000000000000000000000101
1000000000000000001100000000000000000000000000000000000000000011
1000000000000000001100000000000000000000000000000000000001011111
1000000000000000001100000000000000000000000000000000000000100111
1000000000000000001111111111111111111111000000000000000001000101
1000000000000000001111111111111111111111000000000000000001001101
1000000000000000001100000011000000000000000000000000000000000111
1000000000000000001100000011000000000000000000000000000001111101
1000000000000000001100000011000000000000000000000000000001111101
1000000000000000001100000011000000000000000000000000000001011001
1000000000000000001100000011000000000000000000000000000000011001
1000000000000000001100000011000000000000000N00000000000000011111
1000000000000000001100000011000000000000000000000000000000011111
1000000000000000001100000011000000000000000000000000000001111111
1000000001111111111100000011000000000000000000000000000001000101
1000000001111111111100000011000000000000000000000000000001001111
1000000000000000001100000011000000000000000000000000000000101001
1000000000000000001100000011000000000000000000000000000001101011
1000000000000000001100000011000000000000000000000000000000110001
1000000000000000001100000011000000000000000000000000000000110111
1000000000000000001100000011000000000000000000000000000001011001
1000000000000000001100000011000000000000000000000000000000000001
1000000000000000001100000011000000000000000000000000000001001111
1000000000000000001100000000000000000000000000000000000000100011
1000000000000000001100000000000000000000000000000000000001110111
1000000000000000001100000000000000000000000000000000000000101111
1000000000000000001100000000000000000000000000000000000000010101
1000000000000000001100000000000000000000000000000000000000110001
1000000000000000001100000000000000000000000000000000000001000101
1010101110111100000101110011011111111011111111100111000010110111
1111101100011011000111001101101100000100011011110110011000110101
1001010111110111001001110010010010100101111011110111000111100101
1110110001010001110110001110000011101010110001100110101100110001
1000010111000111110010101110111010000011110111110011100011101001
1111111000111011110010011110101010011011000111010110101110001111
1110010010010111011001001101001001001101100000001001100000100111
1000101010100000010111101011000011111100000011111101011000010001
1010000001011100000100100010001101100000001010010001100111111111
1010111001111011110000000111011000110111101000010001011010000011
1100000100010101111101101011011010110110010010110001100000000111
1000011111001101000010101011011001001001101001000110001110011001
1000000001010100100100011100101000100010010111001111111110010011
1111111111111111111111111111111111111111111111111111111111111111