NO ./texture/NO.png
SO ./texture/SO.png
WE ./texture/WE.png
EA ./texture/EA.png

F 153,204,255                                        
C 209,160,240

11111111111111111111111111111111111111111111111111111111111111111111111111111111111111111111111111111111111111111111111111111111
11111010001101000010001010111001110001001001100000010111100101111000010001110111111000001001001110010111001100001000101111110111
11100100000011011101111110111100100011110101011100111001001001101010111001111110100010111111101111111001101010111111001000110101
11001000011110011010001100110000101100011000011101010110010100011111000110010100111001001111011110000110110010100011000011110011
11100111000010110011111101011010001011001010111011101001000100010000100011000100000000110010000100011001001000110010111110001101
11011111101000010000100000000100001100011010011111100100100101011011000011011010000000001101101100111110110100010101100101111011
10101111010111100111001110011110001111010010011010100000111001110000101110001011011001001111100111011011111100000000100000000011
11100011110011010100111110000110000110110000111010101111011011000111101110100011000100110011111111001100010110100100010111100011
11100110111111110110011111101000100100000000000011001111111110100110011001110010101111110000001111110101010001011111010010010011
10110011010000000010010010000011001001010110101111001001100101101111000011101001100110011010001111101001110100110101011001111111
11110010011100010011000010110110100011001010110001111001111110000001000100111000011000100110110011111011110110101111101001000001
11001001001010100111001001100100001101101110111110100000010000110100010110110010001110000101101000111110110101110100100101000001
11101100011010111101110001110100000010001010110011100111110111100011001110000101111011100101101000001011110100101011011101100001
11000000111100010111111011000101101010010100001110000011111010011010110110101001010011000101001001110011001000111101001101110111
11001000001100011001010100010011010100011111101110010110010010001110100101001011111000000100011010111010100100011101001100011101
11100110101110100101000111010111110101010100011101000000010111000001101101110001011001110011110010111001101110001001001101111011
10010111110010111010000100101001001111100010000111001111101101010010000100001111101001000101001000011110001000100101100111000011
11010101110111011001001100110110100001010000001000001100110011111010101110110111001111110111001101011010100011000001010000010111
1000111111110000000010111110010111110100110111000101110111010110011001110010011001011110N010001110101000111101001100101100111011
11100001111001100111101101110011000011001010111101000001011100100100111000011110011010011111111010111101010011010000111011001101
10100101011001000010111000101110100111001101101101110111010011000110011110100000110110001100101100101001111110101011111000100011
10100011011111101010100000001010111100001011011100110010010011001001101011100001010101000000010011101001001110010111001101111001
11111110100001000110111000110101101010110000010001100100111011001110110010100111001010111100001101100011000000111001011001010001
10100111111111110001111101111001001000011011000111001010000111111100001000101111101111110000101100010011000111001000110100111001
11010110100010010010101011100111010101011010000010111101110011000011111110101011000100011000101111010001111110011110111100111011
10111101010110001110010111111100000111011011101110010110111010001100011001000111000100000011111010011101100111000100000010010101
10100011110001011010011101001110100110001010100000100010111100110001110111000101010000101111101010001001001101011011001010100111
11001100001011001001100000001010110010001011000001000101101101001101100001110000100111000100100100111001111010011011100010001001
10010010100011000001100111111001100110001001011010110111001111011110010001010001011111101011101101111000111100110110110000000011
10110011101111011000110101010111011001101010011111001010111101101011111111000111001100000101010010001111111001101010001101000111
10110001110101111100110000110011110000110000100001001010110101001011000011110111000100110111001011001011100011000100000010100001
10110011001111100011000100010000110001110001111011111100000110011101100111100110111111101000111000110110010010101101100010100101
11101101011000111110010010010010111110110110000010110001000100001101001000001101001110111101001000010000110100100111100110011111
10110010111100000100100111000000110111011111100101001011001010101001001101110001000101011010000011001100100101110010110101101111
10110001111101000101000101010001000011011100010010001111111101000011011001101011110110010011110010110111011010101110111100001011
11110000011100001101001100111100101100000110010110000110001001111011100010001010010101010100110101000111011100111001110001101001
11001011010111010011010111111011010010010011001001110000001111000000000011101111111110111000110100101100010010111001110000110001
11100110010011110100111011010111100010110110110100011010011011000101110100100011001011010010100011101000101101001011110110110111
10101111100011100110100010010010111100000010100111010110010110101000000011001110100010001000111011101001010001011011010000001001
11001100010011011000000011100101001000100000000000110101100100001000111110101101001000111101011111110000110111111101101111010011
11110110101011000000000011101111101100111001100000010110010010110001100100000101001110110000110110010101001010000011101111010111
11101100011101001101011011000010111010101001111000010010000000011000010001100001100110111101111110000011001111001011011101001111
10011001101100100001000001011101011000101010011101000110000110010001111111100001111110110110100101110011101100111101011011001101
10100001000000001110001100101001111111111000111101001110001101111001101101011100101011001001110001000111110010100000101101110001
10000011100111010001011101001000000100011111111111001011100110000001011110110101100100111010001110111011001001100010101101100001
10010010111001101101111111011100000110001001100101011111001100101010111000001011101110100011011001100101001101011100101000011111
10010010101101001010100111110011110101000100101110010111111110001011011010010001011010001000100100010011101010111010001001010001
10100101001001101011000001001000001001110110001011001100011001010100000011101011111001000101001100000001011110100110011000011111
10000101110111110100001111111010000000010111111010101100010100010100010011111100100000000100111101101000001110111100100011001001
10011110001101000101011001111010011001010111001000101110100110010000110010110011110010110101011011010101101110111111101011010101
10101101011011010001010111110110000001111011100101111111111000110110001010000111110100111011111111110111111110101010110011010111
10110110101011111010100100110011010111111100100100010001111111001001100011110110011100011010011110010001110000100111110010000011
10110110110010101010000110001011101010101011001101111001101000010011110110001100010010100100001111010011001011100011101011000111
11101010101110010101000111001101110110111110111111010101011001101010111010100111100010011000100000100010011111011001000010001011
11110011110011101100101011101100010100101011000101110001101100100101001011011111101100111110101111101010110111101101111111101011
10111011111000101101100110000110011101000010010101001010101000010110100101011101100010010001110100000001000110100101011000100011
10101010010000110101111100111000001111001110101010101110000001001001001100101011111001010101100001011010001011000000011110001001
11100110110101010011011010101010110010100011100101110101001010111110101101101011010110111000111001011001011100001100001111000111
11011101110100011110101111101101001100000111011110011100111110111101001011110001100100100010000000101110101011000000011110001011
10000110000010100100010010011000001110111111001001101000001100011111001000000101100110010101100001011110111011001100101101001011
10110111010001100001110011010010010000010110101001101111100010000011110101110110011011010111010110010000100011110010011001101011
10101010000011000111001011000001000001110111010001111000111111110000000100010000110000001110111100000010010010111101000101001001
11001010000100000010000011101011011011011110000001111001000010011111101011011100001011111001000010001110110110101001000111011011
10110111010101000111011110010000101001000001101111100111001110111100111011010100110111110111000000010001100110011011011010011011
10011110000010000111100101000000001110100011101110001111010100000111100001111001011010000110001101101110101101100000100011101011
11010110001000101001010001001100001001010011100101011111100110001101000101000111110000101011110010010001111111101101110111110111
10001110110111101011101110001111110011111000000001100100111010000001111111001010011101011100101101110100101100010000110001010001
10111000001010100110100101101000000001101010000001011110010110111001111010110111100101000001111100001011100101110101110011011111
11101010011101001100111010001011101010001100111000010110111000101101100111000111000110100011011011001010011111010000001110110001
10110010011100100001000001110011100111011001011010000110111011010101000101000011000101000010111111011000000000001011000001000111
10010000100111001110100000001100001110001100110111000100111010110111111110000100001011000011010011111001011100000101100011100101
10011100101111001010110011011000100000001011000010000001111011010100000101100000010100000111001010010010110100001100011111111001
11001011010011001011000010110101010111101000110111110011100010100011111101010101100001110100111101100111010001101001001101000101
10110011101010000000101000011001001111111000001010101111110111001110000111011101000111011010111110110001100110101001110111011111
11100111001110111111001011011101101110010010010010100100101110000101011111111001010010111110110000111100001110110100110010101011
11000100011000010001100010111100110100100110100111011001110000111011000111111101000111101100010100101100011110110100001111110101
10110110100011011011010001111101010000111000110100111110100110110100010111011110100000010000000001011100101101100000101111000101
10011010001110110110100000000000111001011111100010110101101000101001010001000011110001001101110010001101110110000000100111010111
11000100111100111110011011010011100100000010110111001100010001011111101101100000011111110011100101111101011000111100100111110101
11100000110100011000000000010000110111110000110110000100010001101100000010100101111000010110011000010101010010100001001110000001
10111001001101111101011010111010011010110111011101001010001001111011001011011011010101100110100111000001100000011110110000001101
10111011011011000100100010001000101100011110100001111100111111000010100111100111000101000000000110110111010101000000101101001111
10110010000110010011000011000111100011100001010100110010100011010100000001001110011001010111100001011001010111111100100111010001
11111111010111101010001001110100101111001101101100011011000111001101011111001110011111010100110000000110110010110100111010010101
10011010011011110010011100000111100010101100100101001011011011101111110111110101000101100000010100001100100001111101100101000001
11100000100001011101000101011001001100100101110111101111011101101010110001111111011100100111111000010100001010111101010010010111
10110001100010010011111110100111001101000111010110001000000010110001110010101001100110100100000010110011010110110111010100001001
10011011111001001100101000000011100110001011111101000001001100011000111111011101001111101111111011000011110110001010000000001001
11100100000100011000100001110000000010011001100000001011010101000000011011000100100011111101111011100101111011100011011100001101
10010001000011110010011111110010101100110100001101001111111000010011110100000000111011100011101110110110011101011011111010101101
11010101100101111111101101111100001001010001011101101010101110111000001101001001101011110011000100110001111000011101101010100001
10011000101111101100010111000110000101001110101101101100110010111001000111010001010100111001101000010111010100000100010101001001
11001000011010110001101110111110001000011011100100000110001101100011011011100101111110110010101110111011010010101111101101100001
11110011100011000110010100000111100010110101101010010100001011110010111000111111011111110111110000110010011100111001100111001011
10011111010101000100010110011010101010001110101101100101100101011100001101101101101011110110011111110101100110000000101110011101
11001111110110000001110000111011111001101011100011011111010111001000101010101010011001001101101000100001001011110001111111100111
10011101011111100110010101010111110111011110000011100000100011101110001110010001001110111011001000001010001010000101011100000011
11100000111001111111111110111000011001111010101100111010100010100111000011110000111101001001001011110010011010000011001110100101
11011011011110111111100000100110000010111111100010001110000111110011001110100101011100101000001100110000101001010111101101100011
11100000100100000010001001101000101111011001000100011111111101011101010111101110100000101011010011100100001010010010101110010011
10101000001000110101011100101110111101101110100000001100101010101110010011101111110001010100111000000110110101001110000000011111
11111111111100010011000101111100001010001101110000000100001011011011111010000011011101010101101011110001111010110100101010011001
10010100001011110110011111111100100100111101100010011100011101001111000001011001011010111101101001011011010110001101100011010101
11101110000111100100000011011111111110010111010110101000010110001000101000110101100010100011010111010001011101101011110111110101
11110000100001001000111011001001101111110101010001010000000000101001101010111111111001100000111110011101101111010101100101111101
10110011011010000000100111000111110111011011000001110001101001110010011000001110110011011110101001101000011101111101111010011111
11000101000001001110011101110010001100101100110001000011100101100101011111000000000110101100101100010101011010000111001111010101
11000000111001011101000111110111001101010110010111000000100110011001001110011010000000000111111011010001001010100010100000011111
11110101100011011000001111011011011101000101101011110100111101010011000011101001001100011001110101101111100110000011110000010001
11110010111101010001011101101111010101101000000101111010101110100000111101001000101100101010011011000100111010011101011011000111
11001100001000010010011010001000100010100000110100111000101010100111001001001011010000011010111100000001010001011101011011010111
11100110011101010011100000010011110100110110010110111001111001000100111011111010100100111000000001011100001000010110101101101101
11111010101001011010001011110100010111000000110101101001001100000101110111001100111001101001011000011000000110101111100000111111
10100111110111000110100001111111111110010001100111111010101000001010000000011011011110010001111011001111110110010010000011001011
11101111101001000000011000000011100101111010100101110111010100110100101010010001001100000110110110101001101111011000100010111001
10110100010000001100011111100100101101000110010000011100101010110010100110001100011101111110111011111101111001000110100010101011
11101001110101100001010111110011110001011101001001111100010111100000011011110011100010001010000000000000100001111100001100000001
10101101100101111000000001110000010110111010001011100100101110100111010010111100111011010101110010101010101111010001000001111111
10101001000011000111100001000101111000100101010100111010100000011101011001100011111110001001010110010010100011100011010110111111
11110110010110100001110100001000110100111001010110101000111101010011110101101100110101011011011011110111011111101010100010011011
11110101010000101110100001101000100111011010001101100111111100110110100011100100011000111011100100010110110001110100110111111101
10010001111100111011100110000000000110100111000000110001001100000110110100101010101101011010110100100101100100110001100010110101
10000101101101011010100101001000010110110101101011000101001010010001010111011001101110110100011111110111010111100111100111001101
10110111100100101100001010010101000000000010100010100100111000111001001010101010100111100111110100111100010110111000010000101111
11101011111011101111010010000001011101110010111100010001011110010011110101111000001000110110010100101100110111000100011110101101
11101110000001001011101101100011100000010011111111010010100010100001011000100101101111100000001100101010000111110001110000110001
11110011101000000111101001010010110000010010011100111100001001000000001111011110111000110001110111000000000011011100010011010011
10101110000111111010101010011101011000000101101100010010111101111010111010100111011100010111000000000000011011000000001011110011
11111111111111111111111111111111111111111111111111111111111111111111111111111111111111111111111111111111111111111111111111111111