NO ./texture/NO.png
SO ./texture/SO.png
WE ./texture/WE.png
EA ./texture/EA.png

F 153,204,255                                        
C 209,160,240

11111111111111111111111111111111
11010111000000011001000110100111
10101001010000000000100000101111
10101111000100001010111001011111
10101011010000011001111001110101
10011100111110011011110100100001
11000111000000100000001101111011
11011010111000111110001011001001
10010101110010000100110001100111
11010010011001000000001101101111
11010E00110000011000110110000111
11001001110010111111100000010001
11110111010100100110101001000001
10000100001110011001011000011111
11110001100011111111100100000011
11011101000000101100000111101101
10000001010111101000000101011001
11101011111001111101011011110011
11000100111011111111000110101001
11100100101110110110000101101101
10011011001111000000110001010001
10000011000001110000011010100011
11011101010001110010011110000011
10001101010011101011011000011011
11000011000001100000001100010001
11111110001010100011111110101001
11110110010111010111011101111111
11111010010010110100011101010101
10100110110000010011111001001101
11010111010010010010000011000101
11110011011100000011000001111101
11101001100001001101011011110111
11111111111111111111111111111111