NO ./texture/NO.png
SO ./texture/SO.png
WE ./texture/WE.png
EA ./texture/azro_wall.png

F 100,100,100
C 150,200,255

 111111
10000001
100000001
100010001
10000001
100000001
100000001
1000N0001
100000001
100010001
100001001
100000001
111111111