NO ./texture/NO.png
SO ./texture/SO.png
WE ./texture/WE.png
EA ./texture/EA.png

F 153,204,255                                        
C 209,160,240

 11111111111111111111111111111111111111111111111111111111111111
1101000000000001001010101110000001001110100001111011110001110101
1100111000101001010011110001110110100001111000111101100110100001
1000001000100000101010001011101111110001100010100011100111010011
1001000011000011000000000101011111001111111110011010101110011111
1100101011000111100101111010110000100010100001111101001001011111
1100110000100000000000101010011001100010111010111110001111110001
1011011001011010101111011001110011011001011011111001001000101011
1000100000001001111001111010100101001110001011100001011010001011
1111101111001010110111101111001000101100011011110010011100110011
1101011111100101111111000000110100001001001000000100111101110111
1010001010100110001011011111100110011011000111011110001001000101
1101101110101010100110010011010111001110101110001100010011010011
1100111001111111111000101100111100011110011111101011110000000101
1000001110110101100000001111110101110110101000110000110000101101
1001010010110100100111110101101100000101011100011111110101101101
1001101101011000011000011000010101111111110101011100001000011101
1001110111001110101010110110111100010111000110111100011110011111
1101100011101110001110100101010111101010000000001100000111010011
1111110000110111110001101001000000100111101100100101011011110011
1010111010100010011000000101111101110010010011011110000110111001
1011111110110111000110110011110011001010001110001011010011111111
1001000101010100001110110100110001011111110110101100111100000101
1000011000000111010100100001100011111001110101100000001100000011
1000110011101010110011000011011111010111000101011000000011011111
1001001110000111101111011010010010110001001011111100001010100111
1010011011000110011001101110010111100010001010011001010001000101
1000110001000000110001010110101011011011001011101000101011001101
1001110111011111101100101100100111101111100001000101010000000111
1111100001100101011010111000111000000010000001100101111111111101
1000110101111010010100100001101001000011000001000100110111111101
1011011111011101011101011001000000000101000001101101110101011001
1110011111101110111100110101001010111001000001100100100110011001
1001011000010100001011100111110000111000001101101011101100011111
1101111100101100000000000001100100110111101001100101001010011111
1011001010000001000111011011010101011011000011001010000001111111
1111010010010011110001000010101011001011000100110100110101000101
1111010000011001010111000111101101011010000001001100000101001111
1101111010100110100100101110011001001100111001101010100110101001
1110111000111011100101010011111100001101111000010010000001101011
1011000011101101100101010100010111111110010110110N01001110110001
1100110111111000001011001001100000001011110110000010001000110111
1000001011011111101101011100011100111101100100001001001101011001
1000111011111111000100100110111110100010000101100000000000000001
1001111101111101101110010001111110101110010100101101001101001111
1001010010010101011001011101100011111101010000110111101100100011
1010100011101000101101010000000100100100011010011101011111110111
1000001110001111110001001011001100110000000001001011011010101111
1111100001010101000101011010011111011000000110011010000110010101
1011111101111100001111111000110111101100110000100011110100110001
1111001101010100100001110100001110010101000010101111010011000101
1010101110111100000101110011011111111011111111100111000010110111
1111101100011011000111001101101100000100011011110110011000110101
1001010111110111001001110010010010100101111011110111000111100101
1110110001010001110110001110000011101010110001100110101100110001
1000010111000111110010101110111010000011110111110011100011101001
1111111000111011110010011110101010011011000111010110101110001111
1110010010010111011001001101001001001101100000001001100000100111
1000101010100000010111101011000011111100000011111101011000010001
1010000001011100000100100010001101100000001010010001100111111111
1010111001111011110000000111011000110111101000010001011010000011
1100000100010101111101101011011010110110010010110001100000000111
1000011111001101000010101011011001001001101001000110001110011001
1000000001010100100100011100101000100010010111001111111110010011
1111111111111111111111111111111111111111111111111111111111111111