NO ./texture/NO.png
SO ./texture/SO.png
WE ./texture/WE.png
EA ./texture/azro_wall.png

F 153,204,255                                        
C 209,160,240

111111111111111111111
111111111111111111111
111111111111111111111
111111111111111111111
111100000000000001111
111100000000000001111
111100000000000001111
111100000000000001111
111100000000000001111
111100000000000001111
111100000000000001111
1111000000W0000001111
111100000000000001111
111100000000000001111
111100000000000001111
111100000000000001111
111100000000000001111
111100000000000001111
111100000000000001111
111111111111111111111
111111111111111111111
111111111111111111111
111111111111111111111